NO texture/north_texture.xpm
SO texture/south_texture.xpm
WE texture/west_texture.xpm
EA texture/east_texture.xpm

F 0,100,255
C 255,,0

111111111111111
100000000000101
100101000010101
101110000010101
1000E0000010101
100000101111101
100001010000001
100000100000001
111111000111101
100000000000011
111111111111111